WWWWWWW
WXX000W
WXX000W
W00000W
W00000W
WWWWWWW
4,1
3,1
3,3
2,3
2,4