WWWWWW
W0X00W
W0000W
W0000W
W0000W
W0000W
W0000W
WWWWWW
3,3
2,3

