WWWWWW
W00XWW
WW000W
W0X00W
W0000W
W0000W
W0000W
WWWWWW
1,1
1,2
2,2


