WWWWWW
W000WW
WX0X0W
W00W0W
W0000W
WWWWWW
1,1
0,0
0,0

