WWWWWW
W000WW
W0XX0W
W00W0W
W0000W
WWWWWW
1,1
3,1
2,1

