WWWWWWW
W0000WW
W00000W
W0WX0XW
W00000W
WWWWWWW
4,5
3,5
4,1